organizations:
	getAllOrganizations =>  GET: /api/organizations
	getOrganization =>  GET: /api/organizations/:organizationID
	createOrganization =>  POST: /api/organizations
	updateOrganization =>  PUT: /api/organizations/:organizationID
	deleteOrganization =>  DELETE: /api/organizations/:organizationID

users:
	getAllUsers =>  GET: /api/users
	getUser =>  GET: /api/users/:userID
	createUser =>  POST: /api/users
	updateUser =>  PUT: /api/users/:userID
	deleteUser =>  DELETE: /api/users/:userID

admins:
	getAllAdmins =>  GET: /api/admins
	getAdmin =>  GET: /api/admins/:adminID
	createAdmin =>  POST: /api/admins
	updateAdmin =>  PUT: /api/admins/:adminID
	deleteAdmin =>  DELETE: /api/admins/:adminID

books:
	getAllBooks =>  GET: /api/books
	getBook =>  GET: /api/books/:bookID
	createBook =>  POST: /api/books
	updateBook =>  PUT: /api/books/:bookID
	deleteBook =>  DELETE: /api/books/:bookID

volumes:
	getAllVolumesFilteredByBookID =>  GET: /api/books/:bookID/volumes
	getVolumeFilteredByBookID =>  GET: /api/books/:bookID/volumes/:volumeID
	createVolume =>  POST: /api/books/:bookID/volumes
	updateVolume =>  PUT: /api/books/:bookID/volumes/:volumeID
	deleteVolume =>  DELETE: /api/books/:bookID/volumes/:volumeID

chapters:
	getAllChaptersFilteredByVolumeID =>  GET: /api/books/:bookID/volumes/:volumeID/chapters
	getChapterFilteredByVolumeID =>  GET: /api/books/:bookID/volumes/:volumeID/chapters/:chapterID
	createChapter =>  POST: /api/books/:bookID/volumes/:volumeID/chapters
	updateChapter =>  PUT: /api/books/:bookID/volumes/:volumeID/chapters/:chapterID
	deleteChapter =>  DELETE: /api/books/:bookID/volumes/:volumeID/chapters/:chapterID

documents:
	getAllDocumentsFilteredByChapterID =>  GET: /api/books/:bookID/volumes/:volumeID/chapters/:chapterID/documents
	getDocumentFilteredByChapterID =>  GET: /api/books/:bookID/volumes/:volumeID/chapters/:chapterID/documents/:documentID
	createDocument =>  POST: /api/books/:bookID/volumes/:volumeID/chapters/:chapterID/documents
	updateDocument =>  PUT: /api/books/:bookID/volumes/:volumeID/chapters/:chapterID/documents/:documentID
	deleteDocument =>  DELETE: /api/books/:bookID/volumes/:volumeID/chapters/:chapterID/documents/:documentID

documentHistories:
	getAllDocumentHistoriesFilteredByUserID =>  GET: /api/users/:userID/documentHistories
	getAllDocumentHistoriesFilteredByDocumentID =>  GET: /api/documents/:documentID/documentHistories
	getAllDocumentHistoriesFilteredByUserIDAndDocumentID =>  GET: /api/users/:userID/documents/:documentID/documentHistories
	getDocumentHistorieFilteredByUserIDAndDocumentID =>  GET: /api/users/:userID/documents/:documentID/documentHistories/:documentHistorieID
	createDocumentHistorie =>  POST: /api/users/:userID/documents/:documentID/documentHistories
	updateDocumentHistorie =>  PUT: /api/users/:userID/documents/:documentID/documentHistories/:documentHistorieID
	deleteDocumentHistorie =>  DELETE: /api/users/:userID/documents/:documentID/documentHistories/:documentHistorieID

histories:
	getAllHistoriesFilteredByUserID =>  GET: /api/users/:userID/histories
	getHistorieFilteredByUserID =>  GET: /api/users/:userID/histories/:historieID
	createHistorie =>  POST: /api/users/:userID/histories
	updateHistorie =>  PUT: /api/users/:userID/histories/:historieID
	deleteHistorie =>  DELETE: /api/users/:userID/histories/:historieID

glossaries:
	getAllGlossaries =>  GET: /api/glossaries
	getGlossary =>  GET: /api/glossaries/:glossaryID
	createGlossary =>  POST: /api/glossaries
	updateGlossary =>  PUT: /api/glossaries/:glossaryID
	deleteGlossary =>  DELETE: /api/glossaries/:glossaryID

inquiries:
	getAllInquiriesFilteredByUserID =>  GET: /api/users/:userID/inquiries
	getAllInquiriesFilteredByDocumentID =>  GET: /api/documents/:documentID/inquiries
	getAllInquiriesFilteredByUserIDAndDocumentID =>  GET: /api/users/:userID/documents/:documentID/inquiries
	getInquiryFilteredByUserIDAndDocumentID =>  GET: /api/users/:userID/documents/:documentID/inquiries/:inquiryID
	createInquiry =>  POST: /api/users/:userID/documents/:documentID/inquiries
	updateInquiry =>  PUT: /api/users/:userID/documents/:documentID/inquiries/:inquiryID
	deleteInquiry =>  DELETE: /api/users/:userID/documents/:documentID/inquiries/:inquiryID

